亲子亲子装	亲子	
女POLO衫	POLO衫	
女T恤	T恤	
女一字裙/A字裙	裙,字	
女丁字裤	裤,丁字	
女七分裤	裤,七分	7分
女三角裤	裤,三角	
女丝袜/网袜	袜	丝
女中裙	裙,中	及膝
女中跟鞋	鞋,中跟	
女九分裤	裤,九分	9分
女五分裤	裤,五分	5分
女低跟鞋	鞋,低跟	
女保龄球包	包,保龄球	
女信封包	包,信封	
女公主裙	裙,公主	
女内衣	内衣	保暖
女内裤	裤,内	
女冲锋衣	冲锋衣	
女凉拖	凉拖	
女凉鞋	鞋,凉	
女凯莉包	包,凯莉	凯利,凯丽
女制服/套装	制服	套装,OL套装
女剑桥包	包,剑桥	
女包臀裙/铅笔裙	裙,包臀	铅笔
女半裙	裙,半	
女单肩包	包,单肩	
女单鞋/船鞋	鞋,单	船
女卡其裤	裤,卡其	
女卫衣	卫衣	加绒卫衣
女印花裤	裤,印花	
女及踝鞋	靴,及踝	
女双肩包	包,双肩	
女吊带	吊带	系带,挂脖
女吊带袜	袜	吊带
女吊带裙/系带裙	裙,吊带	系带,挂脖
女哈伦裤	裤,哈伦	
女喇叭裤	裤,喇叭	喇叭腿
女圆头鞋	鞋,圆头	
女坡跟鞋	鞋,坡跟	
女塑形衣	衣,塑形
女复古包	包,复古	古董
女大衣/风衣	大衣|风衣	呢子大衣
女夹脚鞋	鞋,夹脚	夹趾,人字拖
女娃娃鞋	鞋,娃娃	
女子母包	包,子母	
女安全裤	裤,安全	
女宴会包	包,宴会	晚宴,宴席
女家居服	家居服	
女小脚裤	裤,小脚	窄脚
女尖头鞋	鞋,尖头	
女布鞋	鞋,布	
女帆布包	包,帆布	
女帆布鞋	鞋,帆布	匡威,converse
女帽衫	帽衫	连帽
女平底鞋	鞋,平底	
女平角裤	裤,平角	
女开衫	开衫	
女戴妃包/黛妃包	包,戴妃	黛妃
女手包	包,手	
女打底衫	打底衫	打底,上衣
女打底裤	裤,打底	踩脚,假透肉
女披肩	披肩	
女拖鞋	鞋,拖	居家,室内
女挎包/斜挎包	包,挎	斜挎,斜跨
女新娘包	包,新娘	
女新娘鞋	鞋,新娘	
女方口鞋	鞋,方口	
女旅游鞋	鞋,旅游	
女木底鞋	鞋,木底	木屐
女机车包	包,机车	
女机车靴/哈雷靴	靴,机车	哈雷
女松糕鞋	鞋,松糕	厚底
女板鞋	鞋,板	
女果冻鞋	鞋,果冻鞋	
女柏金包	包,柏金	
女格纹包	包,格纹	
女棉衣/棉服	棉衣	棉服
女棉袜	袜	棉
女棉裤/加绒裤	裤,棉	加绒
女毛衣	毛衣	毛线,海马毛
女水桶包	包,水桶	
女沙滩裙	裙,沙滩	波西米亚
女沙滩鞋	鞋,沙滩	波西米亚
女波士顿包	包,波士顿	
女泳衣	泳	衣
女洞洞鞋	鞋,洞洞	卡骆驰,crocs
女流苏包	包,流苏	
女浅口鞋	鞋,浅口	
女浴袍/浴衣	浴	衣
女灯笼裤	裤,灯笼	
女热裤	裤,热	
女牛仔裙	裙,牛仔	
女牛仔裤	裤,牛仔	加绒牛仔
女牛津鞋	鞋,牛津	
女球鞋	鞋,球	
女瑜伽裤	裤,瑜伽	
女登山鞋	鞋,登山	
女百褶裙	裙,百褶	
女皮包	包,皮	
女皮衣	皮衣	皮夹克
女夹克  夹克|外套   
女大衣	大衣    
女直筒裤	裤,直筒	
女睡衣/睡袍	睡,衣	
女睡裙	睡裙	
女短袜	袜	短
女短裙	裙,短	
女短裤	裤,短	
女短靴	靴,短	
女粗跟鞋	鞋,粗跟	
女糖果鞋	鞋,糖果鞋	
女系带鞋	鞋,系带	绑带
女纱裙	裙,纱	欧根纱
女细跟鞋	鞋,细跟	
女罗马鞋/绑带鞋	鞋,罗马	角斗士,绑带
女羽绒服	羽绒	服,坎肩,马甲,马夹
女羽绒裤	裤,羽绒	
女背带裤	裤,背带	
女背心	背心	工字背心
女背心裙	裙,背心	
女胸罩/文胸	胸罩|文胸	
女腰包	包,腰	
女船袜	袜	船
女芭蕾鞋	鞋,芭蕾	
女花苞裙	裙,花苞	
女草编包	包,草编	编织
女蕾丝衫	蕾丝衫	
女蛋糕裙	裙,蛋糕	
女蝙蝠衫	蝙蝠袖	
女衬衫	衬衫	正装,法兰绒,格子
女裙裤	裤,裙	
女西装/正装	西装	小西装,正装,工作服
女西装裤	裤,西装	工装,正装
女豆豆鞋	鞋,豆豆	
女贝壳包	包,贝壳	
女超短裙/迷你裙	裙,超短	迷你
女跑步鞋	鞋,跑步	
女运动服/运动衣	运动	
女运动裤	裤,运动	
女运动鞋	鞋,运动	
女连体裤/连身裤	裤,连体	连身
女连衣裙/连身裙	裙,连衣	连身,全身
女连裤袜	袜	连裤
女透明包	包,透明	果冻
女邮差包	包,邮差	
女针织衫	针织	
女钱包	包,钱	钱夹,零钱
女铅笔裤	裤,铅笔	
女铆钉包	包,铆钉	
女链条包	包,链条	
女长筒袜	袜	长筒
女长裙	裙,长	及踝
女长裤	裤,长	
女长靴	靴,长	高筒
女阔腿裤	裤,阔腿	
女防晒衫/空调衫	防晒衫	防紫外线,空调衫
女防水台	防水台	
女雪地靴	靴,雪地	UGG,皮毛一体
女雪纺衫	雪纺衫	
女雪纺裙	裙,雪纺	
女雪纺裤	裤,雪纺	
女马丁靴	靴,马	马丁
女马甲	马甲	马夹
女马鞍包	包,马鞍	
女高跟鞋	鞋,高跟	酒杯跟,细高跟,粗高跟
女鱼嘴鞋	鞋,鱼嘴	
女鱼尾裙	裙,尾	
女旗袍  旗袍    
男POLO衫	POLO衫	
男T恤	T恤	
男七分裤	裤,七分	7分
男三角裤	裤,三角	
男乐福鞋	鞋,乐福	
男五分裤	裤,五分	5分
男休闲包	包,休闲	
男休闲裤	裤,休闲	
男休闲鞋	鞋,休闲	
男信封包	包,信封	
男公事包	包,公事	
男内衣	内衣	保暖
男内裤	裤,内	
男冲锋衣	冲锋衣	
男凉鞋	鞋,凉	
男单肩包	包,单肩	
男卡其裤	裤,卡其	
男卫衣	卫衣,加绒卫衣	
男双肩包	包,双肩	
男坎肩	坎肩	
男大衣	大衣,呢子大衣	
男夹克	夹克	
男夹脚鞋	鞋,夹脚	夹趾,人字拖
男家居服	家居服	
男小脚裤/窄脚裤	裤,小脚	窄脚
男工具包/电脑包	包,工具	电脑
男布鞋	鞋,布	
男帆布包	包,帆布	
男帆布鞋	鞋,帆布	匡威,converse
男帽衫	帽衫,连帽	
男平角裤	裤,平角	
男开衫	开衫	
男手包	包,手	手拿,手抓
男打底衫	打底衫	
男拖鞋	鞋,拖	室内,居家
男挎包/斜挎包	包,挎	斜挎,斜跨
男提包	包,提	手提
男旅游鞋	鞋,旅游	
男木底鞋	鞋,木底	木屐
男机车包	包,机车	
男机车靴/哈雷靴	靴,机车	哈雷
男板鞋	鞋,板	
男棉衣/棉服	棉衣,棉服	
男棉袜	袜	棉
男棉裤/加绒裤	裤,棉	加绒
男毛衣	毛衣|羊毛衫	毛坎肩	
男沙滩裤	裤,沙滩	海滩
男沙滩鞋	鞋,沙滩	
男泳裤	泳	裤
男洞洞鞋	鞋,洞洞	卡骆驰,crocs
男浴袍/浴衣	浴	衣
男涉水鞋	鞋,涉水	
男牛仔裤	裤,牛仔	
男牛津鞋	鞋,牛津底	
男球鞋	鞋,球	
男登山鞋	鞋,登山	
男皮包/皮夹	包,皮	
男皮衣	皮衣	
男皮靴	靴,皮	
男直筒裤	裤,直筒	
男睡衣/睡袍	睡,衣	
男短袜	袜	短
男短裤	裤,短	
男窄腿裤	裤,窄腿	
男羽绒服	羽绒	
男背带裤	裤,背带	
男背心	背心	
男腰包	包,腰	
男衬衫	衬衫,正装	法兰绒,,格子
男西装/正装	西装,正装	
男西装裤	裤,西装	工装
男豆豆鞋	鞋,豆豆	
男跑步鞋	鞋,跑步	
男运动包	包,运动	
男运动服/运动衣	运动服	
男运动裤	裤,运动	
男运动鞋	鞋,运动	
男邮差包	包,邮差	
男针织衫	针织	
男钥匙包	包,钥匙	
男钱包	包,钱	钱夹
男铅笔裤	裤,铅笔	
男长裤	裤,长	
男雪地靴	靴,雪地	UGG,皮毛一体
男风衣	风衣	
男马丁靴	靴,马丁	
男马甲	马甲,马夹	
男马靴	靴,马	
男马鞍包	包,马鞍	
童T恤	T恤	
童内衣裤/睡衣	内衣	睡
童卫衣/绒衣	卫衣	绒衣
童外套/大衣	外套	大衣
童套装	套装	演出服
童女童裙装	裙	
童棉衣/棉服	棉衣	棉服
童毛衣/针织衫	毛衣	针织衫
童童装裤子	裤	
童童鞋	鞋	
童羽绒服	羽绒服	
童衬衫	衬衫	
童马甲/背心	马甲	背心
